KUMPULAN CHEAT KHUSUS GTA SA ANDROID (FULL/LITE) 

                  (Cheat Senjata GTA SA) 
Armor ,Uang ,Darah.        : (ada di video) 
Bidik saat mengemudi     : RYSMRM
Pejalan kaki Ber Senjata  : GDNXHDK
Peluru Tak Terbatas         : NECUMZ
Senjata 1.                          : (ada di video)            
Senjata 2                           : (ada di video)          
Senjata 3                           : (ada di video) 
Senjata 4                           : BIEUHQY

                (Cheat Polisi GTA SA) 
Anti polisi / polisi baik            : (ada di video) 
Naikin bintang polisi               : (ada di video) 
Polisi bintang 6                        : (ada di video) 
Turunin bintang polisi             : (ada di video) 

                (Cheat Cuaca GTA SA) 
Cuaca badai                             : EAKILHM
Cuaca badai pasir                   : JBWDWWO
Cuaca hangat                          : AAEXPPQC
Cuaca hujan                             : TAVPIER
Cuaca Kabut                            : EGCEBVM
Cuaca mendung                      : VBWEMQX
Cuaca panas.                           : HTRTTVJ
Lewati 4 Jam.                           : YACKMWS
Selalu jam 00:00.                     : AWUJNBB
Selalu jam 21:00.                     : KTGDLXY
Waktu Sangat Cepat              : OWAKIJ

                  (Cheat Player GTA SA) 
Adrenalin                             : SLSNRKK
Bernafas dalam air            : POOOJOX
Berotot                                : SGVDSQW
Bunuh Diri                          : SLOTSFK
full respect                          : MTGIISR
Elvis                                      : LNHVOAE
Gemuk.                                : AESHXWQI
Geng menguasai kota       : HAPOHXR
Geng menyerangmu          : EAMLJNN
Jetpack                                : (ada di video) 

Kebal (darah tak terbatas)      : GONPXWR
Kekacauan di kota             : AKOZBCH
kiamat                                 : NJXPCYE
Kota mati atau sepi           : DEHDRX
Kurus                                   : AWXDCRJ
Lari jadi Cepat                    : EHWBWDS
Lari jadi lambat                  : FNJFCZC

Lompat Tinggi                     : (ada di video) 
Parasut                                : (ada di video) 
Pukulan maut /Super       : (ada di video) 

Rekrut rpg atau basoka     : QAONHOH
Rekrut senjata AK47.         : AWIOMPH
Rekrut.                                  : JEZRPI
Seks Appeal Penuh           : APGZLQR
Semua orang menyerangmu  : FARYJHZ
Skill Judi meningkat          : AFJKBNRP
Stamina.                             : AEZLCKXU
Tema badut                        : HDLIWGB
Tema ninja                          : AAUSQP
Tema pantai.                      : BWCMMTD
Tema pelacur                     : BNIZWSB
Tema warga desa              : OAXCCRI
Tidak Pernah lapar            : KBTMUVH
Warga desa menyerang    : ERFBFNI

                      (Cheat Kendaraan GTA SA) 
Lalu lintas agresif                 : IOKXTFJ
Lampu lalu lintas hijau         : ENQCFMA
Limusin (mobil presiden)   : IXSMWCQ
Lompatan super di bmx       : TDBKCEH
Mengemudi gila                    : DLNNHZJ

Mobil Balap 1                       : (ada di video) 
Mobil Balap 2                       : (ada di video) 

Mobil Balap 3                       : HPGPIJZ
Mobil Balap Rancher          : BIGLWCDD
Mobil berjalan di air              : BDBGXNJI
Mobil di tabrak melayang    : JBVIJXA
Mobil ditabrak meledak (mobil kebal)       : BXBTUBTI
Mobil Golf                             : DAHESZY
Mobil jenazah                      : PSPNATX
Mobil Terbang                       : (ada di video) 
Nitro                                        : WUSDOTO
Pesawat                                : PTHSEO
Pesawat Jet                         : AWPTMIIQ
Semua mobil bagus            : FRIUBIL
Semua mobil jadi hitam.    : GOYDVAO
Semua mobil jadi pink       : GYKVYTR
Semua mobil jelek.             : JTBCSN
Semua mobil meledak          : BKFONFE
Truk sampah                         : QPOLSVK
Tank baja                               : (ada di video) 

